1111111111111111111
1000000000000001111
1011011111001001111
1011011111001001111
10110000EP110001111
101101111100C001111
101101111100C001111
1111111111111111111