1111111111111111111
1000000000000000001
1001011111001001101
10010000EP110001101
100101111100C001101
100101111100C001101
1000000000000000001
1111111111111111111